222222222222
250112211052
200112211002
211112211112
211110011112
222100001222
222100001222
211110011112
211112211112
200112211002
250112211052
222222222222