222222222222
250112211052
200112211002
211112211112
211111111112
222212212222
222212212222
211111111112
211112211112
200112211002
250112211052
222222222222