222222222222
250111111052
200221122002
212111111212
212121121212
211111111112
211111111112
212121121212
212111111212
200221122002
250111111052
222222222222