*****XX****X********XXXX
XX******XX**XXXXXX***XXX
XX***XXXX**XXXXX****XXXX
XX***XXXXXXXXXXXXXX****X
*****XXXXXX**********XXX
XX*************XXXX*****